/* utf8_to_win874.map */
/* This file is generated by src/unicode/maps/UCS_to_most.py */

static const uint16_t win874_from_unicode_tree_table[396];

static const flb_mb_radix_tree win874_from_unicode_tree = {
  win874_from_unicode_tree_table,
  NULL,

  0x0000, 0x00, 0x00,
  0x0040, 0xc2, 0xc2, 0xa0, 0xa0,
  0x0042, 0xe0, 0xe2, 0x80, 0xb9, 0x80, 0xbf,
  0x0000, 0x00, 0x00, 0x00, 0x00, 0x00, 0x00, 0x00, 0x00
};

static const uint16_t win874_from_unicode_tree_table[396] = {

  /*** Dummy map, for invalid values - offset 0x00000 ***/

  /* 00 */ 0x0000, 0x0000, 0x0000, 0x0000, 0x0000, 0x0000, 0x0000, 0x0000,
  /* 08 */ 0x0000, 0x0000, 0x0000, 0x0000, 0x0000, 0x0000, 0x0000, 0x0000,
  /* 10 */ 0x0000, 0x0000, 0x0000, 0x0000, 0x0000, 0x0000, 0x0000, 0x0000,
  /* 18 */ 0x0000, 0x0000, 0x0000, 0x0000, 0x0000, 0x0000, 0x0000, 0x0000,
  /* 20 */ 0x0000, 0x0000, 0x0000, 0x0000, 0x0000, 0x0000, 0x0000, 0x0000,
  /* 28 */ 0x0000, 0x0000, 0x0000, 0x0000, 0x0000, 0x0000, 0x0000, 0x0000,
  /* 30 */ 0x0000, 0x0000, 0x0000, 0x0000, 0x0000, 0x0000, 0x0000, 0x0000,
  /* 38 */ 0x0000, 0x0000, 0x0000, 0x0000, 0x0000, 0x0000, 0x0000, 0x0000,

  /*** Two byte table, byte #1: xx - offset 0x00040 ***/

  /* c2 */ 0x0041,

  /*** Two byte table, leaf: c2xx - offset 0x00041 ***/

  /* a0 */ 0x00a0,

  /*** Three byte table, byte #1: xx - offset 0x00042 ***/

  /* e0 */ 0x0045, 0x0000, 0x007f,

  /*** Three byte table, byte #2: e0xx - offset 0x00045 ***/

  /* 80 */ 0x0000, 0x0000, 0x0000, 0x0000, 0x0000, 0x0000, 0x0000, 0x0000,
  /* 88 */ 0x0000, 0x0000, 0x0000, 0x0000, 0x0000, 0x0000, 0x0000, 0x0000,
  /* 90 */ 0x0000, 0x0000, 0x0000, 0x0000, 0x0000, 0x0000, 0x0000, 0x0000,
  /* 98 */ 0x0000, 0x0000, 0x0000, 0x0000, 0x0000, 0x0000, 0x0000, 0x0000,
  /* a0 */ 0x0000, 0x0000, 0x0000, 0x0000, 0x0000, 0x0000, 0x0000, 0x0000,
  /* a8 */ 0x0000, 0x0000, 0x0000, 0x0000, 0x0000, 0x0000, 0x0000, 0x0000,
  /* b0 */ 0x0000, 0x0000, 0x0000, 0x0000, 0x0000, 0x0000, 0x0000, 0x0000,
  /* b8 */ 0x00b8, 0x00f8,

  /*** Three byte table, byte #2: e2xx - offset 0x0007f ***/

  /* 80 */ 0x0125, 0x0000, 0x014c, 0x0000, 0x0000, 0x0000, 0x0000, 0x0000,
  /* 88 */ 0x0000, 0x0000, 0x0000, 0x0000, 0x0000, 0x0000, 0x0000, 0x0000,
  /* 90 */ 0x0000, 0x0000, 0x0000, 0x0000, 0x0000, 0x0000, 0x0000, 0x0000,
  /* 98 */ 0x0000, 0x0000, 0x0000, 0x0000, 0x0000, 0x0000, 0x0000, 0x0000,
  /* a0 */ 0x0000, 0x0000, 0x0000, 0x0000, 0x0000, 0x0000, 0x0000, 0x0000,
  /* a8 */ 0x0000, 0x0000, 0x0000, 0x0000, 0x0000, 0x0000, 0x0000, 0x0000,
  /* b0 */ 0x0000, 0x0000, 0x0000, 0x0000, 0x0000, 0x0000, 0x0000, 0x0000,
  /* b8 */ 0x0000,
    /* 1 trailing zero values shared with next segment */

  /*** Three byte table, leaf: e0b8xx - offset 0x000b8 ***/

  /* 80 */ 0x0000, 0x00a1, 0x00a2, 0x00a3, 0x00a4, 0x00a5, 0x00a6, 0x00a7,
  /* 88 */ 0x00a8, 0x00a9, 0x00aa, 0x00ab, 0x00ac, 0x00ad, 0x00ae, 0x00af,
  /* 90 */ 0x00b0, 0x00b1, 0x00b2, 0x00b3, 0x00b4, 0x00b5, 0x00b6, 0x00b7,
  /* 98 */ 0x00b8, 0x00b9, 0x00ba, 0x00bb, 0x00bc, 0x00bd, 0x00be, 0x00bf,
  /* a0 */ 0x00c0, 0x00c1, 0x00c2, 0x00c3, 0x00c4, 0x00c5, 0x00c6, 0x00c7,
  /* a8 */ 0x00c8, 0x00c9, 0x00ca, 0x00cb, 0x00cc, 0x00cd, 0x00ce, 0x00cf,
  /* b0 */ 0x00d0, 0x00d1, 0x00d2, 0x00d3, 0x00d4, 0x00d5, 0x00d6, 0x00d7,
  /* b8 */ 0x00d8, 0x00d9, 0x00da, 0x0000, 0x0000, 0x0000, 0x0000, 0x00df,

  /*** Three byte table, leaf: e0b9xx - offset 0x000f8 ***/

  /* 80 */ 0x00e0, 0x00e1, 0x00e2, 0x00e3, 0x00e4, 0x00e5, 0x00e6, 0x00e7,
  /* 88 */ 0x00e8, 0x00e9, 0x00ea, 0x00eb, 0x00ec, 0x00ed, 0x00ee, 0x00ef,
  /* 90 */ 0x00f0, 0x00f1, 0x00f2, 0x00f3, 0x00f4, 0x00f5, 0x00f6, 0x00f7,
  /* 98 */ 0x00f8, 0x00f9, 0x00fa, 0x00fb, 0x0000, 0x0000, 0x0000, 0x0000,
  /* a0 */ 0x0000, 0x0000, 0x0000, 0x0000, 0x0000, 0x0000, 0x0000, 0x0000,
  /* a8 */ 0x0000, 0x0000, 0x0000, 0x0000, 0x0000,
    /* 19 trailing zero values shared with next segment */

  /*** Three byte table, leaf: e280xx - offset 0x00125 ***/

  /* 80 */ 0x0000, 0x0000, 0x0000, 0x0000, 0x0000, 0x0000, 0x0000, 0x0000,
  /* 88 */ 0x0000, 0x0000, 0x0000, 0x0000, 0x0000, 0x0000, 0x0000, 0x0000,
  /* 90 */ 0x0000, 0x0000, 0x0000, 0x0096, 0x0097, 0x0000, 0x0000, 0x0000,
  /* 98 */ 0x0091, 0x0092, 0x0000, 0x0000, 0x0093, 0x0094, 0x0000, 0x0000,
  /* a0 */ 0x0000, 0x0000, 0x0095, 0x0000, 0x0000, 0x0000, 0x0085,
    /* 25 trailing zero values shared with next segment */

  /*** Three byte table, leaf: e282xx - offset 0x0014c ***/

  /* 80 */ 0x0000, 0x0000, 0x0000, 0x0000, 0x0000, 0x0000, 0x0000, 0x0000,
  /* 88 */ 0x0000, 0x0000, 0x0000, 0x0000, 0x0000, 0x0000, 0x0000, 0x0000,
  /* 90 */ 0x0000, 0x0000, 0x0000, 0x0000, 0x0000, 0x0000, 0x0000, 0x0000,
  /* 98 */ 0x0000, 0x0000, 0x0000, 0x0000, 0x0000, 0x0000, 0x0000, 0x0000,
  /* a0 */ 0x0000, 0x0000, 0x0000, 0x0000, 0x0000, 0x0000, 0x0000, 0x0000,
  /* a8 */ 0x0000, 0x0000, 0x0000, 0x0000, 0x0080, 0x0000, 0x0000, 0x0000,
  /* b0 */ 0x0000, 0x0000, 0x0000, 0x0000, 0x0000, 0x0000, 0x0000, 0x0000,
  /* b8 */ 0x0000, 0x0000, 0x0000, 0x0000, 0x0000, 0x0000, 0x0000, 0x0000
};
