/* utf8_to_win1255.map */
/* This file is generated by src/unicode/maps/UCS_to_most.py */

static const uint16_t win1255_from_unicode_tree_table[548];

static const flb_mb_radix_tree win1255_from_unicode_tree = {
  win1255_from_unicode_tree_table,
  NULL,

  0x0000, 0x00, 0x00,
  0x0040, 0xc2, 0xd7, 0x80, 0xbf,
  0x01a5, 0xe2, 0xe2, 0x80, 0x84, 0x8e, 0xba,
  0x0000, 0x00, 0x00, 0x00, 0x00, 0x00, 0x00, 0x00, 0x00
};

static const uint16_t win1255_from_unicode_tree_table[548] = {

  /*** Dummy map, for invalid values - offset 0x00000 ***/

  /* 00 */ 0x0000, 0x0000, 0x0000, 0x0000, 0x0000, 0x0000, 0x0000, 0x0000,
  /* 08 */ 0x0000, 0x0000, 0x0000, 0x0000, 0x0000, 0x0000, 0x0000, 0x0000,
  /* 10 */ 0x0000, 0x0000, 0x0000, 0x0000, 0x0000, 0x0000, 0x0000, 0x0000,
  /* 18 */ 0x0000, 0x0000, 0x0000, 0x0000, 0x0000, 0x0000, 0x0000, 0x0000,
  /* 20 */ 0x0000, 0x0000, 0x0000, 0x0000, 0x0000, 0x0000, 0x0000, 0x0000,
  /* 28 */ 0x0000, 0x0000, 0x0000, 0x0000, 0x0000, 0x0000, 0x0000, 0x0000,
  /* 30 */ 0x0000, 0x0000, 0x0000, 0x0000, 0x0000, 0x0000, 0x0000, 0x0000,
  /* 38 */ 0x0000, 0x0000, 0x0000, 0x0000, 0x0000, 0x0000, 0x0000, 0x0000,

  /*** Two byte table, byte #1: xx - offset 0x00040 ***/

  /* c2 */ 0x0056, 0x0096, 0x0000, 0x0000, 0x00ce, 0x0000, 0x0000, 0x0000,
  /* ca */ 0x0000, 0x0108, 0x0000, 0x0000, 0x0000, 0x0000, 0x0000, 0x0000,
  /* d2 */ 0x0000, 0x0000, 0x0000, 0x0000, 0x0125, 0x0165,

  /*** Two byte table, leaf: c2xx - offset 0x00056 ***/

  /* 80 */ 0x0000, 0x0000, 0x0000, 0x0000, 0x0000, 0x0000, 0x0000, 0x0000,
  /* 88 */ 0x0000, 0x0000, 0x0000, 0x0000, 0x0000, 0x0000, 0x0000, 0x0000,
  /* 90 */ 0x0000, 0x0000, 0x0000, 0x0000, 0x0000, 0x0000, 0x0000, 0x0000,
  /* 98 */ 0x0000, 0x0000, 0x0000, 0x0000, 0x0000, 0x0000, 0x0000, 0x0000,
  /* a0 */ 0x00a0, 0x00a1, 0x00a2, 0x00a3, 0x0000, 0x00a5, 0x00a6, 0x00a7,
  /* a8 */ 0x00a8, 0x00a9, 0x0000, 0x00ab, 0x00ac, 0x00ad, 0x00ae, 0x00af,
  /* b0 */ 0x00b0, 0x00b1, 0x00b2, 0x00b3, 0x00b4, 0x00b5, 0x00b6, 0x00b7,
  /* b8 */ 0x00b8, 0x00b9, 0x0000, 0x00bb, 0x00bc, 0x00bd, 0x00be, 0x00bf,

  /*** Two byte table, leaf: c3xx - offset 0x00096 ***/

  /* 80 */ 0x0000, 0x0000, 0x0000, 0x0000, 0x0000, 0x0000, 0x0000, 0x0000,
  /* 88 */ 0x0000, 0x0000, 0x0000, 0x0000, 0x0000, 0x0000, 0x0000, 0x0000,
  /* 90 */ 0x0000, 0x0000, 0x0000, 0x0000, 0x0000, 0x0000, 0x0000, 0x00aa,
  /* 98 */ 0x0000, 0x0000, 0x0000, 0x0000, 0x0000, 0x0000, 0x0000, 0x0000,
  /* a0 */ 0x0000, 0x0000, 0x0000, 0x0000, 0x0000, 0x0000, 0x0000, 0x0000,
  /* a8 */ 0x0000, 0x0000, 0x0000, 0x0000, 0x0000, 0x0000, 0x0000, 0x0000,
  /* b0 */ 0x0000, 0x0000, 0x0000, 0x0000, 0x0000, 0x0000, 0x0000, 0x00ba,
    /* 8 trailing zero values shared with next segment */

  /*** Two byte table, leaf: c6xx - offset 0x000ce ***/

  /* 80 */ 0x0000, 0x0000, 0x0000, 0x0000, 0x0000, 0x0000, 0x0000, 0x0000,
  /* 88 */ 0x0000, 0x0000, 0x0000, 0x0000, 0x0000, 0x0000, 0x0000, 0x0000,
  /* 90 */ 0x0000, 0x0000, 0x0083, 0x0000, 0x0000, 0x0000, 0x0000, 0x0000,
  /* 98 */ 0x0000, 0x0000, 0x0000, 0x0000, 0x0000, 0x0000, 0x0000, 0x0000,
  /* a0 */ 0x0000, 0x0000, 0x0000, 0x0000, 0x0000, 0x0000, 0x0000, 0x0000,
  /* a8 */ 0x0000, 0x0000, 0x0000, 0x0000, 0x0000, 0x0000, 0x0000, 0x0000,
  /* b0 */ 0x0000, 0x0000, 0x0000, 0x0000, 0x0000, 0x0000, 0x0000, 0x0000,
  /* b8 */ 0x0000, 0x0000,
    /* 6 trailing zero values shared with next segment */

  /*** Two byte table, leaf: cbxx - offset 0x00108 ***/

  /* 80 */ 0x0000, 0x0000, 0x0000, 0x0000, 0x0000, 0x0000, 0x0088, 0x0000,
  /* 88 */ 0x0000, 0x0000, 0x0000, 0x0000, 0x0000, 0x0000, 0x0000, 0x0000,
  /* 90 */ 0x0000, 0x0000, 0x0000, 0x0000, 0x0000, 0x0000, 0x0000, 0x0000,
  /* 98 */ 0x0000, 0x0000, 0x0000, 0x0000, 0x0098,
    /* 35 trailing zero values shared with next segment */

  /*** Two byte table, leaf: d6xx - offset 0x00125 ***/

  /* 80 */ 0x0000, 0x0000, 0x0000, 0x0000, 0x0000, 0x0000, 0x0000, 0x0000,
  /* 88 */ 0x0000, 0x0000, 0x0000, 0x0000, 0x0000, 0x0000, 0x0000, 0x0000,
  /* 90 */ 0x0000, 0x0000, 0x0000, 0x0000, 0x0000, 0x0000, 0x0000, 0x0000,
  /* 98 */ 0x0000, 0x0000, 0x0000, 0x0000, 0x0000, 0x0000, 0x0000, 0x0000,
  /* a0 */ 0x0000, 0x0000, 0x0000, 0x0000, 0x0000, 0x0000, 0x0000, 0x0000,
  /* a8 */ 0x0000, 0x0000, 0x0000, 0x0000, 0x0000, 0x0000, 0x0000, 0x0000,
  /* b0 */ 0x00c0, 0x00c1, 0x00c2, 0x00c3, 0x00c4, 0x00c5, 0x00c6, 0x00c7,
  /* b8 */ 0x00c8, 0x00c9, 0x0000, 0x00cb, 0x00cc, 0x00cd, 0x00ce, 0x00cf,

  /*** Two byte table, leaf: d7xx - offset 0x00165 ***/

  /* 80 */ 0x00d0, 0x00d1, 0x00d2, 0x00d3, 0x0000, 0x0000, 0x0000, 0x0000,
  /* 88 */ 0x0000, 0x0000, 0x0000, 0x0000, 0x0000, 0x0000, 0x0000, 0x0000,
  /* 90 */ 0x00e0, 0x00e1, 0x00e2, 0x00e3, 0x00e4, 0x00e5, 0x00e6, 0x00e7,
  /* 98 */ 0x00e8, 0x00e9, 0x00ea, 0x00eb, 0x00ec, 0x00ed, 0x00ee, 0x00ef,
  /* a0 */ 0x00f0, 0x00f1, 0x00f2, 0x00f3, 0x00f4, 0x00f5, 0x00f6, 0x00f7,
  /* a8 */ 0x00f8, 0x00f9, 0x00fa, 0x0000, 0x0000, 0x0000, 0x0000, 0x0000,
  /* b0 */ 0x00d4, 0x00d5, 0x00d6, 0x00d7, 0x00d8, 0x0000, 0x0000, 0x0000,
  /* b8 */ 0x0000, 0x0000, 0x0000, 0x0000, 0x0000, 0x0000, 0x0000, 0x0000,

  /*** Three byte table, byte #1: xx - offset 0x001a5 ***/

  /* e2 */ 0x01a6,

  /*** Three byte table, byte #2: e2xx - offset 0x001a6 ***/

  /* 80 */ 0x01ab, 0x0000, 0x01d8, 0x0000, 0x01f7,

  /*** Three byte table, leaf: e280xx - offset 0x001ab ***/

  /* 8e */ 0x00fd, 0x00fe, 0x0000, 0x0000, 0x0000, 0x0096, 0x0097, 0x0000,
  /* 96 */ 0x0000, 0x0000, 0x0091, 0x0092, 0x0082, 0x0000, 0x0093, 0x0094,
  /* 9e */ 0x0084, 0x0000, 0x0086, 0x0087, 0x0095, 0x0000, 0x0000, 0x0000,
  /* a6 */ 0x0085, 0x0000, 0x0000, 0x0000, 0x0000, 0x0000, 0x0000, 0x0000,
  /* ae */ 0x0000, 0x0000, 0x0089, 0x0000, 0x0000, 0x0000, 0x0000, 0x0000,
  /* b6 */ 0x0000, 0x0000, 0x0000, 0x008b, 0x009b,

  /*** Three byte table, leaf: e282xx - offset 0x001d8 ***/

  /* 8e */ 0x0000, 0x0000, 0x0000, 0x0000, 0x0000, 0x0000, 0x0000, 0x0000,
  /* 96 */ 0x0000, 0x0000, 0x0000, 0x0000, 0x0000, 0x0000, 0x0000, 0x0000,
  /* 9e */ 0x0000, 0x0000, 0x0000, 0x0000, 0x0000, 0x0000, 0x0000, 0x0000,
  /* a6 */ 0x0000, 0x0000, 0x0000, 0x0000, 0x00a4, 0x0000, 0x0080,
    /* 14 trailing zero values shared with next segment */

  /*** Three byte table, leaf: e284xx - offset 0x001f7 ***/

  /* 8e */ 0x0000, 0x0000, 0x0000, 0x0000, 0x0000, 0x0000, 0x0000, 0x0000,
  /* 96 */ 0x0000, 0x0000, 0x0000, 0x0000, 0x0000, 0x0000, 0x0000, 0x0000,
  /* 9e */ 0x0000, 0x0000, 0x0000, 0x0000, 0x0099, 0x0000, 0x0000, 0x0000,
  /* a6 */ 0x0000, 0x0000, 0x0000, 0x0000, 0x0000, 0x0000, 0x0000, 0x0000,
  /* ae */ 0x0000, 0x0000, 0x0000, 0x0000, 0x0000, 0x0000, 0x0000, 0x0000,
  /* b6 */ 0x0000, 0x0000, 0x0000, 0x0000, 0x0000
};
