/* utf8_to_win866.map */
/* This file is generated by src/unicode/maps/UCS_to_most.py */

static const uint16_t win866_from_unicode_tree_table[571];

static const flb_mb_radix_tree win866_from_unicode_tree = {
  win866_from_unicode_tree_table,
  NULL,

  0x0000, 0x00, 0x00,
  0x0040, 0xc2, 0xd1, 0x80, 0xbf,
  0x010f, 0xe2, 0xe2, 0x84, 0x96, 0x80, 0xbc,
  0x0000, 0x00, 0x00, 0x00, 0x00, 0x00, 0x00, 0x00, 0x00
};

static const uint16_t win866_from_unicode_tree_table[571] = {

  /*** Dummy map, for invalid values - offset 0x00000 ***/

  /* 00 */ 0x0000, 0x0000, 0x0000, 0x0000, 0x0000, 0x0000, 0x0000, 0x0000,
  /* 08 */ 0x0000, 0x0000, 0x0000, 0x0000, 0x0000, 0x0000, 0x0000, 0x0000,
  /* 10 */ 0x0000, 0x0000, 0x0000, 0x0000, 0x0000, 0x0000, 0x0000, 0x0000,
  /* 18 */ 0x0000, 0x0000, 0x0000, 0x0000, 0x0000, 0x0000, 0x0000, 0x0000,
  /* 20 */ 0x0000, 0x0000, 0x0000, 0x0000, 0x0000, 0x0000, 0x0000, 0x0000,
  /* 28 */ 0x0000, 0x0000, 0x0000, 0x0000, 0x0000, 0x0000, 0x0000, 0x0000,
  /* 30 */ 0x0000, 0x0000, 0x0000, 0x0000, 0x0000, 0x0000, 0x0000, 0x0000,
  /* 38 */ 0x0000, 0x0000, 0x0000, 0x0000, 0x0000, 0x0000, 0x0000, 0x0000,

  /*** Two byte table, byte #1: xx - offset 0x00040 ***/

  /* c2 */ 0x0050, 0x0000, 0x0000, 0x0000, 0x0000, 0x0000, 0x0000, 0x0000,
  /* ca */ 0x0000, 0x0000, 0x0000, 0x0000, 0x0000, 0x0000, 0x008f, 0x00cf,

  /*** Two byte table, leaf: c2xx - offset 0x00050 ***/

  /* 80 */ 0x0000, 0x0000, 0x0000, 0x0000, 0x0000, 0x0000, 0x0000, 0x0000,
  /* 88 */ 0x0000, 0x0000, 0x0000, 0x0000, 0x0000, 0x0000, 0x0000, 0x0000,
  /* 90 */ 0x0000, 0x0000, 0x0000, 0x0000, 0x0000, 0x0000, 0x0000, 0x0000,
  /* 98 */ 0x0000, 0x0000, 0x0000, 0x0000, 0x0000, 0x0000, 0x0000, 0x0000,
  /* a0 */ 0x00ff, 0x0000, 0x0000, 0x0000, 0x00fd, 0x0000, 0x0000, 0x0000,
  /* a8 */ 0x0000, 0x0000, 0x0000, 0x0000, 0x0000, 0x0000, 0x0000, 0x0000,
  /* b0 */ 0x00f8, 0x0000, 0x0000, 0x0000, 0x0000, 0x0000, 0x0000, 0x00fa,
  /* b8 */ 0x0000, 0x0000, 0x0000, 0x0000, 0x0000, 0x0000, 0x0000,
    /* 1 trailing zero values shared with next segment */

  /*** Two byte table, leaf: d0xx - offset 0x0008f ***/

  /* 80 */ 0x0000, 0x00f0, 0x0000, 0x0000, 0x00f2, 0x0000, 0x0000, 0x00f4,
  /* 88 */ 0x0000, 0x0000, 0x0000, 0x0000, 0x0000, 0x0000, 0x00f6, 0x0000,
  /* 90 */ 0x0080, 0x0081, 0x0082, 0x0083, 0x0084, 0x0085, 0x0086, 0x0087,
  /* 98 */ 0x0088, 0x0089, 0x008a, 0x008b, 0x008c, 0x008d, 0x008e, 0x008f,
  /* a0 */ 0x0090, 0x0091, 0x0092, 0x0093, 0x0094, 0x0095, 0x0096, 0x0097,
  /* a8 */ 0x0098, 0x0099, 0x009a, 0x009b, 0x009c, 0x009d, 0x009e, 0x009f,
  /* b0 */ 0x00a0, 0x00a1, 0x00a2, 0x00a3, 0x00a4, 0x00a5, 0x00a6, 0x00a7,
  /* b8 */ 0x00a8, 0x00a9, 0x00aa, 0x00ab, 0x00ac, 0x00ad, 0x00ae, 0x00af,

  /*** Two byte table, leaf: d1xx - offset 0x000cf ***/

  /* 80 */ 0x00e0, 0x00e1, 0x00e2, 0x00e3, 0x00e4, 0x00e5, 0x00e6, 0x00e7,
  /* 88 */ 0x00e8, 0x00e9, 0x00ea, 0x00eb, 0x00ec, 0x00ed, 0x00ee, 0x00ef,
  /* 90 */ 0x0000, 0x00f1, 0x0000, 0x0000, 0x00f3, 0x0000, 0x0000, 0x00f5,
  /* 98 */ 0x0000, 0x0000, 0x0000, 0x0000, 0x0000, 0x0000, 0x00f7, 0x0000,
  /* a0 */ 0x0000, 0x0000, 0x0000, 0x0000, 0x0000, 0x0000, 0x0000, 0x0000,
  /* a8 */ 0x0000, 0x0000, 0x0000, 0x0000, 0x0000, 0x0000, 0x0000, 0x0000,
  /* b0 */ 0x0000, 0x0000, 0x0000, 0x0000, 0x0000, 0x0000, 0x0000, 0x0000,
  /* b8 */ 0x0000, 0x0000, 0x0000, 0x0000, 0x0000, 0x0000, 0x0000, 0x0000,

  /*** Three byte table, byte #1: xx - offset 0x0010f ***/

  /* e2 */ 0x0110,

  /*** Three byte table, byte #2: e2xx - offset 0x00110 ***/

  /* 84 */ 0x0123, 0x0000, 0x0000, 0x0000, 0x0147, 0x0000, 0x0000, 0x0000,
  /* 8c */ 0x0000, 0x0000, 0x0000, 0x0000, 0x0000, 0x0000, 0x0000, 0x0000,
  /* 94 */ 0x0184, 0x01c1, 0x01fe,

  /*** Three byte table, leaf: e284xx - offset 0x00123 ***/

  /* 80 */ 0x0000, 0x0000, 0x0000, 0x0000, 0x0000, 0x0000, 0x0000, 0x0000,
  /* 88 */ 0x0000, 0x0000, 0x0000, 0x0000, 0x0000, 0x0000, 0x0000, 0x0000,
  /* 90 */ 0x0000, 0x0000, 0x0000, 0x0000, 0x0000, 0x0000, 0x00fc, 0x0000,
  /* 98 */ 0x0000, 0x0000, 0x0000, 0x0000, 0x0000, 0x0000, 0x0000, 0x0000,
  /* a0 */ 0x0000, 0x0000, 0x0000, 0x0000,
    /* 25 trailing zero values shared with next segment */

  /*** Three byte table, leaf: e288xx - offset 0x00147 ***/

  /* 80 */ 0x0000, 0x0000, 0x0000, 0x0000, 0x0000, 0x0000, 0x0000, 0x0000,
  /* 88 */ 0x0000, 0x0000, 0x0000, 0x0000, 0x0000, 0x0000, 0x0000, 0x0000,
  /* 90 */ 0x0000, 0x0000, 0x0000, 0x0000, 0x0000, 0x0000, 0x0000, 0x0000,
  /* 98 */ 0x0000, 0x00f9, 0x00fb, 0x0000, 0x0000, 0x0000, 0x0000, 0x0000,
  /* a0 */ 0x0000, 0x0000, 0x0000, 0x0000, 0x0000, 0x0000, 0x0000, 0x0000,
  /* a8 */ 0x0000, 0x0000, 0x0000, 0x0000, 0x0000, 0x0000, 0x0000, 0x0000,
  /* b0 */ 0x0000, 0x0000, 0x0000, 0x0000, 0x0000, 0x0000, 0x0000, 0x0000,
  /* b8 */ 0x0000, 0x0000, 0x0000, 0x0000, 0x0000,

  /*** Three byte table, leaf: e294xx - offset 0x00184 ***/

  /* 80 */ 0x00c4, 0x0000, 0x00b3, 0x0000, 0x0000, 0x0000, 0x0000, 0x0000,
  /* 88 */ 0x0000, 0x0000, 0x0000, 0x0000, 0x00da, 0x0000, 0x0000, 0x0000,
  /* 90 */ 0x00bf, 0x0000, 0x0000, 0x0000, 0x00c0, 0x0000, 0x0000, 0x0000,
  /* 98 */ 0x00d9, 0x0000, 0x0000, 0x0000, 0x00c3, 0x0000, 0x0000, 0x0000,
  /* a0 */ 0x0000, 0x0000, 0x0000, 0x0000, 0x00b4, 0x0000, 0x0000, 0x0000,
  /* a8 */ 0x0000, 0x0000, 0x0000, 0x0000, 0x00c2, 0x0000, 0x0000, 0x0000,
  /* b0 */ 0x0000, 0x0000, 0x0000, 0x0000, 0x00c1, 0x0000, 0x0000, 0x0000,
  /* b8 */ 0x0000, 0x0000, 0x0000, 0x0000, 0x00c5,

  /*** Three byte table, leaf: e295xx - offset 0x001c1 ***/

  /* 80 */ 0x0000, 0x0000, 0x0000, 0x0000, 0x0000, 0x0000, 0x0000, 0x0000,
  /* 88 */ 0x0000, 0x0000, 0x0000, 0x0000, 0x0000, 0x0000, 0x0000, 0x0000,
  /* 90 */ 0x00cd, 0x00ba, 0x00d5, 0x00d6, 0x00c9, 0x00b8, 0x00b7, 0x00bb,
  /* 98 */ 0x00d4, 0x00d3, 0x00c8, 0x00be, 0x00bd, 0x00bc, 0x00c6, 0x00c7,
  /* a0 */ 0x00cc, 0x00b5, 0x00b6, 0x00b9, 0x00d1, 0x00d2, 0x00cb, 0x00cf,
  /* a8 */ 0x00d0, 0x00ca, 0x00d8, 0x00d7, 0x00ce, 0x0000, 0x0000, 0x0000,
  /* b0 */ 0x0000, 0x0000, 0x0000, 0x0000, 0x0000, 0x0000, 0x0000, 0x0000,
  /* b8 */ 0x0000, 0x0000, 0x0000, 0x0000, 0x0000,

  /*** Three byte table, leaf: e296xx - offset 0x001fe ***/

  /* 80 */ 0x00df, 0x0000, 0x0000, 0x0000, 0x00dc, 0x0000, 0x0000, 0x0000,
  /* 88 */ 0x00db, 0x0000, 0x0000, 0x0000, 0x00dd, 0x0000, 0x0000, 0x0000,
  /* 90 */ 0x00de, 0x00b0, 0x00b1, 0x00b2, 0x0000, 0x0000, 0x0000, 0x0000,
  /* 98 */ 0x0000, 0x0000, 0x0000, 0x0000, 0x0000, 0x0000, 0x0000, 0x0000,
  /* a0 */ 0x00fe, 0x0000, 0x0000, 0x0000, 0x0000, 0x0000, 0x0000, 0x0000,
  /* a8 */ 0x0000, 0x0000, 0x0000, 0x0000, 0x0000, 0x0000, 0x0000, 0x0000,
  /* b0 */ 0x0000, 0x0000, 0x0000, 0x0000, 0x0000, 0x0000, 0x0000, 0x0000,
  /* b8 */ 0x0000, 0x0000, 0x0000, 0x0000, 0x0000
};
