/* win1250_to_utf8.map */
/* This file is generated by src/unicode/maps/UCS_to_most.py */

static const uint32_t win1250_to_unicode_tree_table[256];

static const flb_mb_radix_tree win1250_to_unicode_tree = {
  NULL,
  win1250_to_unicode_tree_table,

  0x0080, 0x80, 0xff,
  0x0000, 0x00, 0x00, 0x00, 0x00,
  0x0000, 0x00, 0x00, 0x00, 0x00, 0x00, 0x00,
  0x0000, 0x00, 0x00, 0x00, 0x00, 0x00, 0x00, 0x00, 0x00
};

static const uint32_t win1250_to_unicode_tree_table[256] = {

  /*** Dummy map, for invalid values - offset 0x00000 ***/

  /* 00 */ 0x00000000, 0x00000000, 0x00000000, 0x00000000,
  /* 04 */ 0x00000000, 0x00000000, 0x00000000, 0x00000000,
  /* 08 */ 0x00000000, 0x00000000, 0x00000000, 0x00000000,
  /* 0c */ 0x00000000, 0x00000000, 0x00000000, 0x00000000,
  /* 10 */ 0x00000000, 0x00000000, 0x00000000, 0x00000000,
  /* 14 */ 0x00000000, 0x00000000, 0x00000000, 0x00000000,
  /* 18 */ 0x00000000, 0x00000000, 0x00000000, 0x00000000,
  /* 1c */ 0x00000000, 0x00000000, 0x00000000, 0x00000000,
  /* 20 */ 0x00000000, 0x00000000, 0x00000000, 0x00000000,
  /* 24 */ 0x00000000, 0x00000000, 0x00000000, 0x00000000,
  /* 28 */ 0x00000000, 0x00000000, 0x00000000, 0x00000000,
  /* 2c */ 0x00000000, 0x00000000, 0x00000000, 0x00000000,
  /* 30 */ 0x00000000, 0x00000000, 0x00000000, 0x00000000,
  /* 34 */ 0x00000000, 0x00000000, 0x00000000, 0x00000000,
  /* 38 */ 0x00000000, 0x00000000, 0x00000000, 0x00000000,
  /* 3c */ 0x00000000, 0x00000000, 0x00000000, 0x00000000,
  /* 40 */ 0x00000000, 0x00000000, 0x00000000, 0x00000000,
  /* 44 */ 0x00000000, 0x00000000, 0x00000000, 0x00000000,
  /* 48 */ 0x00000000, 0x00000000, 0x00000000, 0x00000000,
  /* 4c */ 0x00000000, 0x00000000, 0x00000000, 0x00000000,
  /* 50 */ 0x00000000, 0x00000000, 0x00000000, 0x00000000,
  /* 54 */ 0x00000000, 0x00000000, 0x00000000, 0x00000000,
  /* 58 */ 0x00000000, 0x00000000, 0x00000000, 0x00000000,
  /* 5c */ 0x00000000, 0x00000000, 0x00000000, 0x00000000,
  /* 60 */ 0x00000000, 0x00000000, 0x00000000, 0x00000000,
  /* 64 */ 0x00000000, 0x00000000, 0x00000000, 0x00000000,
  /* 68 */ 0x00000000, 0x00000000, 0x00000000, 0x00000000,
  /* 6c */ 0x00000000, 0x00000000, 0x00000000, 0x00000000,
  /* 70 */ 0x00000000, 0x00000000, 0x00000000, 0x00000000,
  /* 74 */ 0x00000000, 0x00000000, 0x00000000, 0x00000000,
  /* 78 */ 0x00000000, 0x00000000, 0x00000000, 0x00000000,
  /* 7c */ 0x00000000, 0x00000000, 0x00000000, 0x00000000,

  /*** Single byte table, leaf: xx - offset 0x00080 ***/

  /* 80 */ 0x00e282ac, 0x00000000, 0x00e2809a, 0x00000000,
  /* 84 */ 0x00e2809e, 0x00e280a6, 0x00e280a0, 0x00e280a1,
  /* 88 */ 0x00000000, 0x00e280b0, 0x0000c5a0, 0x00e280b9,
  /* 8c */ 0x0000c59a, 0x0000c5a4, 0x0000c5bd, 0x0000c5b9,
  /* 90 */ 0x00000000, 0x00e28098, 0x00e28099, 0x00e2809c,
  /* 94 */ 0x00e2809d, 0x00e280a2, 0x00e28093, 0x00e28094,
  /* 98 */ 0x00000000, 0x00e284a2, 0x0000c5a1, 0x00e280ba,
  /* 9c */ 0x0000c59b, 0x0000c5a5, 0x0000c5be, 0x0000c5ba,
  /* a0 */ 0x0000c2a0, 0x0000cb87, 0x0000cb98, 0x0000c581,
  /* a4 */ 0x0000c2a4, 0x0000c484, 0x0000c2a6, 0x0000c2a7,
  /* a8 */ 0x0000c2a8, 0x0000c2a9, 0x0000c59e, 0x0000c2ab,
  /* ac */ 0x0000c2ac, 0x0000c2ad, 0x0000c2ae, 0x0000c5bb,
  /* b0 */ 0x0000c2b0, 0x0000c2b1, 0x0000cb9b, 0x0000c582,
  /* b4 */ 0x0000c2b4, 0x0000c2b5, 0x0000c2b6, 0x0000c2b7,
  /* b8 */ 0x0000c2b8, 0x0000c485, 0x0000c59f, 0x0000c2bb,
  /* bc */ 0x0000c4bd, 0x0000cb9d, 0x0000c4be, 0x0000c5bc,
  /* c0 */ 0x0000c594, 0x0000c381, 0x0000c382, 0x0000c482,
  /* c4 */ 0x0000c384, 0x0000c4b9, 0x0000c486, 0x0000c387,
  /* c8 */ 0x0000c48c, 0x0000c389, 0x0000c498, 0x0000c38b,
  /* cc */ 0x0000c49a, 0x0000c38d, 0x0000c38e, 0x0000c48e,
  /* d0 */ 0x0000c490, 0x0000c583, 0x0000c587, 0x0000c393,
  /* d4 */ 0x0000c394, 0x0000c590, 0x0000c396, 0x0000c397,
  /* d8 */ 0x0000c598, 0x0000c5ae, 0x0000c39a, 0x0000c5b0,
  /* dc */ 0x0000c39c, 0x0000c39d, 0x0000c5a2, 0x0000c39f,
  /* e0 */ 0x0000c595, 0x0000c3a1, 0x0000c3a2, 0x0000c483,
  /* e4 */ 0x0000c3a4, 0x0000c4ba, 0x0000c487, 0x0000c3a7,
  /* e8 */ 0x0000c48d, 0x0000c3a9, 0x0000c499, 0x0000c3ab,
  /* ec */ 0x0000c49b, 0x0000c3ad, 0x0000c3ae, 0x0000c48f,
  /* f0 */ 0x0000c491, 0x0000c584, 0x0000c588, 0x0000c3b3,
  /* f4 */ 0x0000c3b4, 0x0000c591, 0x0000c3b6, 0x0000c3b7,
  /* f8 */ 0x0000c599, 0x0000c5af, 0x0000c3ba, 0x0000c5b1,
  /* fc */ 0x0000c3bc, 0x0000c3bd, 0x0000c5a3, 0x0000cb99
};
