/* win1251_to_utf8.map */
/* This file is generated by src/unicode/maps/UCS_to_most.py */

static const uint32_t win1251_to_unicode_tree_table[256];

static const flb_mb_radix_tree win1251_to_unicode_tree = {
  NULL,
  win1251_to_unicode_tree_table,

  0x0080, 0x80, 0xff,
  0x0000, 0x00, 0x00, 0x00, 0x00,
  0x0000, 0x00, 0x00, 0x00, 0x00, 0x00, 0x00,
  0x0000, 0x00, 0x00, 0x00, 0x00, 0x00, 0x00, 0x00, 0x00
};

static const uint32_t win1251_to_unicode_tree_table[256] = {

  /*** Dummy map, for invalid values - offset 0x00000 ***/

  /* 00 */ 0x00000000, 0x00000000, 0x00000000, 0x00000000,
  /* 04 */ 0x00000000, 0x00000000, 0x00000000, 0x00000000,
  /* 08 */ 0x00000000, 0x00000000, 0x00000000, 0x00000000,
  /* 0c */ 0x00000000, 0x00000000, 0x00000000, 0x00000000,
  /* 10 */ 0x00000000, 0x00000000, 0x00000000, 0x00000000,
  /* 14 */ 0x00000000, 0x00000000, 0x00000000, 0x00000000,
  /* 18 */ 0x00000000, 0x00000000, 0x00000000, 0x00000000,
  /* 1c */ 0x00000000, 0x00000000, 0x00000000, 0x00000000,
  /* 20 */ 0x00000000, 0x00000000, 0x00000000, 0x00000000,
  /* 24 */ 0x00000000, 0x00000000, 0x00000000, 0x00000000,
  /* 28 */ 0x00000000, 0x00000000, 0x00000000, 0x00000000,
  /* 2c */ 0x00000000, 0x00000000, 0x00000000, 0x00000000,
  /* 30 */ 0x00000000, 0x00000000, 0x00000000, 0x00000000,
  /* 34 */ 0x00000000, 0x00000000, 0x00000000, 0x00000000,
  /* 38 */ 0x00000000, 0x00000000, 0x00000000, 0x00000000,
  /* 3c */ 0x00000000, 0x00000000, 0x00000000, 0x00000000,
  /* 40 */ 0x00000000, 0x00000000, 0x00000000, 0x00000000,
  /* 44 */ 0x00000000, 0x00000000, 0x00000000, 0x00000000,
  /* 48 */ 0x00000000, 0x00000000, 0x00000000, 0x00000000,
  /* 4c */ 0x00000000, 0x00000000, 0x00000000, 0x00000000,
  /* 50 */ 0x00000000, 0x00000000, 0x00000000, 0x00000000,
  /* 54 */ 0x00000000, 0x00000000, 0x00000000, 0x00000000,
  /* 58 */ 0x00000000, 0x00000000, 0x00000000, 0x00000000,
  /* 5c */ 0x00000000, 0x00000000, 0x00000000, 0x00000000,
  /* 60 */ 0x00000000, 0x00000000, 0x00000000, 0x00000000,
  /* 64 */ 0x00000000, 0x00000000, 0x00000000, 0x00000000,
  /* 68 */ 0x00000000, 0x00000000, 0x00000000, 0x00000000,
  /* 6c */ 0x00000000, 0x00000000, 0x00000000, 0x00000000,
  /* 70 */ 0x00000000, 0x00000000, 0x00000000, 0x00000000,
  /* 74 */ 0x00000000, 0x00000000, 0x00000000, 0x00000000,
  /* 78 */ 0x00000000, 0x00000000, 0x00000000, 0x00000000,
  /* 7c */ 0x00000000, 0x00000000, 0x00000000, 0x00000000,

  /*** Single byte table, leaf: xx - offset 0x00080 ***/

  /* 80 */ 0x0000d082, 0x0000d083, 0x00e2809a, 0x0000d193,
  /* 84 */ 0x00e2809e, 0x00e280a6, 0x00e280a0, 0x00e280a1,
  /* 88 */ 0x00e282ac, 0x00e280b0, 0x0000d089, 0x00e280b9,
  /* 8c */ 0x0000d08a, 0x0000d08c, 0x0000d08b, 0x0000d08f,
  /* 90 */ 0x0000d192, 0x00e28098, 0x00e28099, 0x00e2809c,
  /* 94 */ 0x00e2809d, 0x00e280a2, 0x00e28093, 0x00e28094,
  /* 98 */ 0x00000000, 0x00e284a2, 0x0000d199, 0x00e280ba,
  /* 9c */ 0x0000d19a, 0x0000d19c, 0x0000d19b, 0x0000d19f,
  /* a0 */ 0x0000c2a0, 0x0000d08e, 0x0000d19e, 0x0000d088,
  /* a4 */ 0x0000c2a4, 0x0000d290, 0x0000c2a6, 0x0000c2a7,
  /* a8 */ 0x0000d081, 0x0000c2a9, 0x0000d084, 0x0000c2ab,
  /* ac */ 0x0000c2ac, 0x0000c2ad, 0x0000c2ae, 0x0000d087,
  /* b0 */ 0x0000c2b0, 0x0000c2b1, 0x0000d086, 0x0000d196,
  /* b4 */ 0x0000d291, 0x0000c2b5, 0x0000c2b6, 0x0000c2b7,
  /* b8 */ 0x0000d191, 0x00e28496, 0x0000d194, 0x0000c2bb,
  /* bc */ 0x0000d198, 0x0000d085, 0x0000d195, 0x0000d197,
  /* c0 */ 0x0000d090, 0x0000d091, 0x0000d092, 0x0000d093,
  /* c4 */ 0x0000d094, 0x0000d095, 0x0000d096, 0x0000d097,
  /* c8 */ 0x0000d098, 0x0000d099, 0x0000d09a, 0x0000d09b,
  /* cc */ 0x0000d09c, 0x0000d09d, 0x0000d09e, 0x0000d09f,
  /* d0 */ 0x0000d0a0, 0x0000d0a1, 0x0000d0a2, 0x0000d0a3,
  /* d4 */ 0x0000d0a4, 0x0000d0a5, 0x0000d0a6, 0x0000d0a7,
  /* d8 */ 0x0000d0a8, 0x0000d0a9, 0x0000d0aa, 0x0000d0ab,
  /* dc */ 0x0000d0ac, 0x0000d0ad, 0x0000d0ae, 0x0000d0af,
  /* e0 */ 0x0000d0b0, 0x0000d0b1, 0x0000d0b2, 0x0000d0b3,
  /* e4 */ 0x0000d0b4, 0x0000d0b5, 0x0000d0b6, 0x0000d0b7,
  /* e8 */ 0x0000d0b8, 0x0000d0b9, 0x0000d0ba, 0x0000d0bb,
  /* ec */ 0x0000d0bc, 0x0000d0bd, 0x0000d0be, 0x0000d0bf,
  /* f0 */ 0x0000d180, 0x0000d181, 0x0000d182, 0x0000d183,
  /* f4 */ 0x0000d184, 0x0000d185, 0x0000d186, 0x0000d187,
  /* f8 */ 0x0000d188, 0x0000d189, 0x0000d18a, 0x0000d18b,
  /* fc */ 0x0000d18c, 0x0000d18d, 0x0000d18e, 0x0000d18f
};
