/* win1255_to_utf8.map */
/* This file is generated by src/unicode/maps/UCS_to_most.py */

static const uint32_t win1255_to_unicode_tree_table[254];

static const flb_mb_radix_tree win1255_to_unicode_tree = {
  NULL,
  win1255_to_unicode_tree_table,

  0x007f, 0x80, 0xfe,
  0x0000, 0x00, 0x00, 0x00, 0x00,
  0x0000, 0x00, 0x00, 0x00, 0x00, 0x00, 0x00,
  0x0000, 0x00, 0x00, 0x00, 0x00, 0x00, 0x00, 0x00, 0x00
};

static const uint32_t win1255_to_unicode_tree_table[254] = {

  /*** Dummy map, for invalid values - offset 0x00000 ***/

  /* 00 */ 0x00000000, 0x00000000, 0x00000000, 0x00000000,
  /* 04 */ 0x00000000, 0x00000000, 0x00000000, 0x00000000,
  /* 08 */ 0x00000000, 0x00000000, 0x00000000, 0x00000000,
  /* 0c */ 0x00000000, 0x00000000, 0x00000000, 0x00000000,
  /* 10 */ 0x00000000, 0x00000000, 0x00000000, 0x00000000,
  /* 14 */ 0x00000000, 0x00000000, 0x00000000, 0x00000000,
  /* 18 */ 0x00000000, 0x00000000, 0x00000000, 0x00000000,
  /* 1c */ 0x00000000, 0x00000000, 0x00000000, 0x00000000,
  /* 20 */ 0x00000000, 0x00000000, 0x00000000, 0x00000000,
  /* 24 */ 0x00000000, 0x00000000, 0x00000000, 0x00000000,
  /* 28 */ 0x00000000, 0x00000000, 0x00000000, 0x00000000,
  /* 2c */ 0x00000000, 0x00000000, 0x00000000, 0x00000000,
  /* 30 */ 0x00000000, 0x00000000, 0x00000000, 0x00000000,
  /* 34 */ 0x00000000, 0x00000000, 0x00000000, 0x00000000,
  /* 38 */ 0x00000000, 0x00000000, 0x00000000, 0x00000000,
  /* 3c */ 0x00000000, 0x00000000, 0x00000000, 0x00000000,
  /* 40 */ 0x00000000, 0x00000000, 0x00000000, 0x00000000,
  /* 44 */ 0x00000000, 0x00000000, 0x00000000, 0x00000000,
  /* 48 */ 0x00000000, 0x00000000, 0x00000000, 0x00000000,
  /* 4c */ 0x00000000, 0x00000000, 0x00000000, 0x00000000,
  /* 50 */ 0x00000000, 0x00000000, 0x00000000, 0x00000000,
  /* 54 */ 0x00000000, 0x00000000, 0x00000000, 0x00000000,
  /* 58 */ 0x00000000, 0x00000000, 0x00000000, 0x00000000,
  /* 5c */ 0x00000000, 0x00000000, 0x00000000, 0x00000000,
  /* 60 */ 0x00000000, 0x00000000, 0x00000000, 0x00000000,
  /* 64 */ 0x00000000, 0x00000000, 0x00000000, 0x00000000,
  /* 68 */ 0x00000000, 0x00000000, 0x00000000, 0x00000000,
  /* 6c */ 0x00000000, 0x00000000, 0x00000000, 0x00000000,
  /* 70 */ 0x00000000, 0x00000000, 0x00000000, 0x00000000,
  /* 74 */ 0x00000000, 0x00000000, 0x00000000, 0x00000000,
  /* 78 */ 0x00000000, 0x00000000, 0x00000000, 0x00000000,
  /* 7c */ 0x00000000, 0x00000000, 0x00000000,

  /*** Single byte table, leaf: xx - offset 0x0007f ***/

  /* 80 */ 0x00e282ac, 0x00000000, 0x00e2809a, 0x0000c692,
  /* 84 */ 0x00e2809e, 0x00e280a6, 0x00e280a0, 0x00e280a1,
  /* 88 */ 0x0000cb86, 0x00e280b0, 0x00000000, 0x00e280b9,
  /* 8c */ 0x00000000, 0x00000000, 0x00000000, 0x00000000,
  /* 90 */ 0x00000000, 0x00e28098, 0x00e28099, 0x00e2809c,
  /* 94 */ 0x00e2809d, 0x00e280a2, 0x00e28093, 0x00e28094,
  /* 98 */ 0x0000cb9c, 0x00e284a2, 0x00000000, 0x00e280ba,
  /* 9c */ 0x00000000, 0x00000000, 0x00000000, 0x00000000,
  /* a0 */ 0x0000c2a0, 0x0000c2a1, 0x0000c2a2, 0x0000c2a3,
  /* a4 */ 0x00e282aa, 0x0000c2a5, 0x0000c2a6, 0x0000c2a7,
  /* a8 */ 0x0000c2a8, 0x0000c2a9, 0x0000c397, 0x0000c2ab,
  /* ac */ 0x0000c2ac, 0x0000c2ad, 0x0000c2ae, 0x0000c2af,
  /* b0 */ 0x0000c2b0, 0x0000c2b1, 0x0000c2b2, 0x0000c2b3,
  /* b4 */ 0x0000c2b4, 0x0000c2b5, 0x0000c2b6, 0x0000c2b7,
  /* b8 */ 0x0000c2b8, 0x0000c2b9, 0x0000c3b7, 0x0000c2bb,
  /* bc */ 0x0000c2bc, 0x0000c2bd, 0x0000c2be, 0x0000c2bf,
  /* c0 */ 0x0000d6b0, 0x0000d6b1, 0x0000d6b2, 0x0000d6b3,
  /* c4 */ 0x0000d6b4, 0x0000d6b5, 0x0000d6b6, 0x0000d6b7,
  /* c8 */ 0x0000d6b8, 0x0000d6b9, 0x00000000, 0x0000d6bb,
  /* cc */ 0x0000d6bc, 0x0000d6bd, 0x0000d6be, 0x0000d6bf,
  /* d0 */ 0x0000d780, 0x0000d781, 0x0000d782, 0x0000d783,
  /* d4 */ 0x0000d7b0, 0x0000d7b1, 0x0000d7b2, 0x0000d7b3,
  /* d8 */ 0x0000d7b4, 0x00000000, 0x00000000, 0x00000000,
  /* dc */ 0x00000000, 0x00000000, 0x00000000, 0x00000000,
  /* e0 */ 0x0000d790, 0x0000d791, 0x0000d792, 0x0000d793,
  /* e4 */ 0x0000d794, 0x0000d795, 0x0000d796, 0x0000d797,
  /* e8 */ 0x0000d798, 0x0000d799, 0x0000d79a, 0x0000d79b,
  /* ec */ 0x0000d79c, 0x0000d79d, 0x0000d79e, 0x0000d79f,
  /* f0 */ 0x0000d7a0, 0x0000d7a1, 0x0000d7a2, 0x0000d7a3,
  /* f4 */ 0x0000d7a4, 0x0000d7a5, 0x0000d7a6, 0x0000d7a7,
  /* f8 */ 0x0000d7a8, 0x0000d7a9, 0x0000d7aa, 0x00000000,
  /* fc */ 0x00000000, 0x00e2808e, 0x00e2808f
};
