/* win1253_to_utf8.map */
/* This file is generated by src/unicode/maps/UCS_to_most.py */

static const uint32_t win1253_to_unicode_tree_table[254];

static const flb_mb_radix_tree win1253_to_unicode_tree = {
  NULL,
  win1253_to_unicode_tree_table,

  0x007f, 0x80, 0xfe,
  0x0000, 0x00, 0x00, 0x00, 0x00,
  0x0000, 0x00, 0x00, 0x00, 0x00, 0x00, 0x00,
  0x0000, 0x00, 0x00, 0x00, 0x00, 0x00, 0x00, 0x00, 0x00
};

static const uint32_t win1253_to_unicode_tree_table[254] = {

  /*** Dummy map, for invalid values - offset 0x00000 ***/

  /* 00 */ 0x00000000, 0x00000000, 0x00000000, 0x00000000,
  /* 04 */ 0x00000000, 0x00000000, 0x00000000, 0x00000000,
  /* 08 */ 0x00000000, 0x00000000, 0x00000000, 0x00000000,
  /* 0c */ 0x00000000, 0x00000000, 0x00000000, 0x00000000,
  /* 10 */ 0x00000000, 0x00000000, 0x00000000, 0x00000000,
  /* 14 */ 0x00000000, 0x00000000, 0x00000000, 0x00000000,
  /* 18 */ 0x00000000, 0x00000000, 0x00000000, 0x00000000,
  /* 1c */ 0x00000000, 0x00000000, 0x00000000, 0x00000000,
  /* 20 */ 0x00000000, 0x00000000, 0x00000000, 0x00000000,
  /* 24 */ 0x00000000, 0x00000000, 0x00000000, 0x00000000,
  /* 28 */ 0x00000000, 0x00000000, 0x00000000, 0x00000000,
  /* 2c */ 0x00000000, 0x00000000, 0x00000000, 0x00000000,
  /* 30 */ 0x00000000, 0x00000000, 0x00000000, 0x00000000,
  /* 34 */ 0x00000000, 0x00000000, 0x00000000, 0x00000000,
  /* 38 */ 0x00000000, 0x00000000, 0x00000000, 0x00000000,
  /* 3c */ 0x00000000, 0x00000000, 0x00000000, 0x00000000,
  /* 40 */ 0x00000000, 0x00000000, 0x00000000, 0x00000000,
  /* 44 */ 0x00000000, 0x00000000, 0x00000000, 0x00000000,
  /* 48 */ 0x00000000, 0x00000000, 0x00000000, 0x00000000,
  /* 4c */ 0x00000000, 0x00000000, 0x00000000, 0x00000000,
  /* 50 */ 0x00000000, 0x00000000, 0x00000000, 0x00000000,
  /* 54 */ 0x00000000, 0x00000000, 0x00000000, 0x00000000,
  /* 58 */ 0x00000000, 0x00000000, 0x00000000, 0x00000000,
  /* 5c */ 0x00000000, 0x00000000, 0x00000000, 0x00000000,
  /* 60 */ 0x00000000, 0x00000000, 0x00000000, 0x00000000,
  /* 64 */ 0x00000000, 0x00000000, 0x00000000, 0x00000000,
  /* 68 */ 0x00000000, 0x00000000, 0x00000000, 0x00000000,
  /* 6c */ 0x00000000, 0x00000000, 0x00000000, 0x00000000,
  /* 70 */ 0x00000000, 0x00000000, 0x00000000, 0x00000000,
  /* 74 */ 0x00000000, 0x00000000, 0x00000000, 0x00000000,
  /* 78 */ 0x00000000, 0x00000000, 0x00000000, 0x00000000,
  /* 7c */ 0x00000000, 0x00000000, 0x00000000,

  /*** Single byte table, leaf: xx - offset 0x0007f ***/

  /* 80 */ 0x00e282ac, 0x00000000, 0x00e2809a, 0x0000c692,
  /* 84 */ 0x00e2809e, 0x00e280a6, 0x00e280a0, 0x00e280a1,
  /* 88 */ 0x00000000, 0x00e280b0, 0x00000000, 0x00e280b9,
  /* 8c */ 0x00000000, 0x00000000, 0x00000000, 0x00000000,
  /* 90 */ 0x00000000, 0x00e28098, 0x00e28099, 0x00e2809c,
  /* 94 */ 0x00e2809d, 0x00e280a2, 0x00e28093, 0x00e28094,
  /* 98 */ 0x00000000, 0x00e284a2, 0x00000000, 0x00e280ba,
  /* 9c */ 0x00000000, 0x00000000, 0x00000000, 0x00000000,
  /* a0 */ 0x0000c2a0, 0x0000ce85, 0x0000ce86, 0x0000c2a3,
  /* a4 */ 0x0000c2a4, 0x0000c2a5, 0x0000c2a6, 0x0000c2a7,
  /* a8 */ 0x0000c2a8, 0x0000c2a9, 0x00000000, 0x0000c2ab,
  /* ac */ 0x0000c2ac, 0x0000c2ad, 0x0000c2ae, 0x00e28095,
  /* b0 */ 0x0000c2b0, 0x0000c2b1, 0x0000c2b2, 0x0000c2b3,
  /* b4 */ 0x0000ce84, 0x0000c2b5, 0x0000c2b6, 0x0000c2b7,
  /* b8 */ 0x0000ce88, 0x0000ce89, 0x0000ce8a, 0x0000c2bb,
  /* bc */ 0x0000ce8c, 0x0000c2bd, 0x0000ce8e, 0x0000ce8f,
  /* c0 */ 0x0000ce90, 0x0000ce91, 0x0000ce92, 0x0000ce93,
  /* c4 */ 0x0000ce94, 0x0000ce95, 0x0000ce96, 0x0000ce97,
  /* c8 */ 0x0000ce98, 0x0000ce99, 0x0000ce9a, 0x0000ce9b,
  /* cc */ 0x0000ce9c, 0x0000ce9d, 0x0000ce9e, 0x0000ce9f,
  /* d0 */ 0x0000cea0, 0x0000cea1, 0x00000000, 0x0000cea3,
  /* d4 */ 0x0000cea4, 0x0000cea5, 0x0000cea6, 0x0000cea7,
  /* d8 */ 0x0000cea8, 0x0000cea9, 0x0000ceaa, 0x0000ceab,
  /* dc */ 0x0000ceac, 0x0000cead, 0x0000ceae, 0x0000ceaf,
  /* e0 */ 0x0000ceb0, 0x0000ceb1, 0x0000ceb2, 0x0000ceb3,
  /* e4 */ 0x0000ceb4, 0x0000ceb5, 0x0000ceb6, 0x0000ceb7,
  /* e8 */ 0x0000ceb8, 0x0000ceb9, 0x0000ceba, 0x0000cebb,
  /* ec */ 0x0000cebc, 0x0000cebd, 0x0000cebe, 0x0000cebf,
  /* f0 */ 0x0000cf80, 0x0000cf81, 0x0000cf82, 0x0000cf83,
  /* f4 */ 0x0000cf84, 0x0000cf85, 0x0000cf86, 0x0000cf87,
  /* f8 */ 0x0000cf88, 0x0000cf89, 0x0000cf8a, 0x0000cf8b,
  /* fc */ 0x0000cf8c, 0x0000cf8d, 0x0000cf8e
};
