/* win874_to_utf8.map */
/* This file is generated by src/unicode/maps/UCS_to_most.py */

static const uint32_t win874_to_unicode_tree_table[248];

static const flb_mb_radix_tree win874_to_unicode_tree = {
  NULL,
  win874_to_unicode_tree_table,

  0x007c, 0x80, 0xfb,
  0x0000, 0x00, 0x00, 0x00, 0x00,
  0x0000, 0x00, 0x00, 0x00, 0x00, 0x00, 0x00,
  0x0000, 0x00, 0x00, 0x00, 0x00, 0x00, 0x00, 0x00, 0x00
};

static const uint32_t win874_to_unicode_tree_table[248] = {

  /*** Dummy map, for invalid values - offset 0x00000 ***/

  /* 00 */ 0x00000000, 0x00000000, 0x00000000, 0x00000000,
  /* 04 */ 0x00000000, 0x00000000, 0x00000000, 0x00000000,
  /* 08 */ 0x00000000, 0x00000000, 0x00000000, 0x00000000,
  /* 0c */ 0x00000000, 0x00000000, 0x00000000, 0x00000000,
  /* 10 */ 0x00000000, 0x00000000, 0x00000000, 0x00000000,
  /* 14 */ 0x00000000, 0x00000000, 0x00000000, 0x00000000,
  /* 18 */ 0x00000000, 0x00000000, 0x00000000, 0x00000000,
  /* 1c */ 0x00000000, 0x00000000, 0x00000000, 0x00000000,
  /* 20 */ 0x00000000, 0x00000000, 0x00000000, 0x00000000,
  /* 24 */ 0x00000000, 0x00000000, 0x00000000, 0x00000000,
  /* 28 */ 0x00000000, 0x00000000, 0x00000000, 0x00000000,
  /* 2c */ 0x00000000, 0x00000000, 0x00000000, 0x00000000,
  /* 30 */ 0x00000000, 0x00000000, 0x00000000, 0x00000000,
  /* 34 */ 0x00000000, 0x00000000, 0x00000000, 0x00000000,
  /* 38 */ 0x00000000, 0x00000000, 0x00000000, 0x00000000,
  /* 3c */ 0x00000000, 0x00000000, 0x00000000, 0x00000000,
  /* 40 */ 0x00000000, 0x00000000, 0x00000000, 0x00000000,
  /* 44 */ 0x00000000, 0x00000000, 0x00000000, 0x00000000,
  /* 48 */ 0x00000000, 0x00000000, 0x00000000, 0x00000000,
  /* 4c */ 0x00000000, 0x00000000, 0x00000000, 0x00000000,
  /* 50 */ 0x00000000, 0x00000000, 0x00000000, 0x00000000,
  /* 54 */ 0x00000000, 0x00000000, 0x00000000, 0x00000000,
  /* 58 */ 0x00000000, 0x00000000, 0x00000000, 0x00000000,
  /* 5c */ 0x00000000, 0x00000000, 0x00000000, 0x00000000,
  /* 60 */ 0x00000000, 0x00000000, 0x00000000, 0x00000000,
  /* 64 */ 0x00000000, 0x00000000, 0x00000000, 0x00000000,
  /* 68 */ 0x00000000, 0x00000000, 0x00000000, 0x00000000,
  /* 6c */ 0x00000000, 0x00000000, 0x00000000, 0x00000000,
  /* 70 */ 0x00000000, 0x00000000, 0x00000000, 0x00000000,
  /* 74 */ 0x00000000, 0x00000000, 0x00000000, 0x00000000,
  /* 78 */ 0x00000000, 0x00000000, 0x00000000, 0x00000000,

  /*** Single byte table, leaf: xx - offset 0x0007c ***/

  /* 80 */ 0x00e282ac, 0x00000000, 0x00000000, 0x00000000,
  /* 84 */ 0x00000000, 0x00e280a6, 0x00000000, 0x00000000,
  /* 88 */ 0x00000000, 0x00000000, 0x00000000, 0x00000000,
  /* 8c */ 0x00000000, 0x00000000, 0x00000000, 0x00000000,
  /* 90 */ 0x00000000, 0x00e28098, 0x00e28099, 0x00e2809c,
  /* 94 */ 0x00e2809d, 0x00e280a2, 0x00e28093, 0x00e28094,
  /* 98 */ 0x00000000, 0x00000000, 0x00000000, 0x00000000,
  /* 9c */ 0x00000000, 0x00000000, 0x00000000, 0x00000000,
  /* a0 */ 0x0000c2a0, 0x00e0b881, 0x00e0b882, 0x00e0b883,
  /* a4 */ 0x00e0b884, 0x00e0b885, 0x00e0b886, 0x00e0b887,
  /* a8 */ 0x00e0b888, 0x00e0b889, 0x00e0b88a, 0x00e0b88b,
  /* ac */ 0x00e0b88c, 0x00e0b88d, 0x00e0b88e, 0x00e0b88f,
  /* b0 */ 0x00e0b890, 0x00e0b891, 0x00e0b892, 0x00e0b893,
  /* b4 */ 0x00e0b894, 0x00e0b895, 0x00e0b896, 0x00e0b897,
  /* b8 */ 0x00e0b898, 0x00e0b899, 0x00e0b89a, 0x00e0b89b,
  /* bc */ 0x00e0b89c, 0x00e0b89d, 0x00e0b89e, 0x00e0b89f,
  /* c0 */ 0x00e0b8a0, 0x00e0b8a1, 0x00e0b8a2, 0x00e0b8a3,
  /* c4 */ 0x00e0b8a4, 0x00e0b8a5, 0x00e0b8a6, 0x00e0b8a7,
  /* c8 */ 0x00e0b8a8, 0x00e0b8a9, 0x00e0b8aa, 0x00e0b8ab,
  /* cc */ 0x00e0b8ac, 0x00e0b8ad, 0x00e0b8ae, 0x00e0b8af,
  /* d0 */ 0x00e0b8b0, 0x00e0b8b1, 0x00e0b8b2, 0x00e0b8b3,
  /* d4 */ 0x00e0b8b4, 0x00e0b8b5, 0x00e0b8b6, 0x00e0b8b7,
  /* d8 */ 0x00e0b8b8, 0x00e0b8b9, 0x00e0b8ba, 0x00000000,
  /* dc */ 0x00000000, 0x00000000, 0x00000000, 0x00e0b8bf,
  /* e0 */ 0x00e0b980, 0x00e0b981, 0x00e0b982, 0x00e0b983,
  /* e4 */ 0x00e0b984, 0x00e0b985, 0x00e0b986, 0x00e0b987,
  /* e8 */ 0x00e0b988, 0x00e0b989, 0x00e0b98a, 0x00e0b98b,
  /* ec */ 0x00e0b98c, 0x00e0b98d, 0x00e0b98e, 0x00e0b98f,
  /* f0 */ 0x00e0b990, 0x00e0b991, 0x00e0b992, 0x00e0b993,
  /* f4 */ 0x00e0b994, 0x00e0b995, 0x00e0b996, 0x00e0b997,
  /* f8 */ 0x00e0b998, 0x00e0b999, 0x00e0b99a, 0x00e0b99b
};
