/* win866_to_utf8.map */
/* This file is generated by src/unicode/maps/UCS_to_most.py */

static const uint32_t win866_to_unicode_tree_table[256];

static const flb_mb_radix_tree win866_to_unicode_tree = {
  NULL,
  win866_to_unicode_tree_table,

  0x0080, 0x80, 0xff,
  0x0000, 0x00, 0x00, 0x00, 0x00,
  0x0000, 0x00, 0x00, 0x00, 0x00, 0x00, 0x00,
  0x0000, 0x00, 0x00, 0x00, 0x00, 0x00, 0x00, 0x00, 0x00
};

static const uint32_t win866_to_unicode_tree_table[256] = {

  /*** Dummy map, for invalid values - offset 0x00000 ***/

  /* 00 */ 0x00000000, 0x00000000, 0x00000000, 0x00000000,
  /* 04 */ 0x00000000, 0x00000000, 0x00000000, 0x00000000,
  /* 08 */ 0x00000000, 0x00000000, 0x00000000, 0x00000000,
  /* 0c */ 0x00000000, 0x00000000, 0x00000000, 0x00000000,
  /* 10 */ 0x00000000, 0x00000000, 0x00000000, 0x00000000,
  /* 14 */ 0x00000000, 0x00000000, 0x00000000, 0x00000000,
  /* 18 */ 0x00000000, 0x00000000, 0x00000000, 0x00000000,
  /* 1c */ 0x00000000, 0x00000000, 0x00000000, 0x00000000,
  /* 20 */ 0x00000000, 0x00000000, 0x00000000, 0x00000000,
  /* 24 */ 0x00000000, 0x00000000, 0x00000000, 0x00000000,
  /* 28 */ 0x00000000, 0x00000000, 0x00000000, 0x00000000,
  /* 2c */ 0x00000000, 0x00000000, 0x00000000, 0x00000000,
  /* 30 */ 0x00000000, 0x00000000, 0x00000000, 0x00000000,
  /* 34 */ 0x00000000, 0x00000000, 0x00000000, 0x00000000,
  /* 38 */ 0x00000000, 0x00000000, 0x00000000, 0x00000000,
  /* 3c */ 0x00000000, 0x00000000, 0x00000000, 0x00000000,
  /* 40 */ 0x00000000, 0x00000000, 0x00000000, 0x00000000,
  /* 44 */ 0x00000000, 0x00000000, 0x00000000, 0x00000000,
  /* 48 */ 0x00000000, 0x00000000, 0x00000000, 0x00000000,
  /* 4c */ 0x00000000, 0x00000000, 0x00000000, 0x00000000,
  /* 50 */ 0x00000000, 0x00000000, 0x00000000, 0x00000000,
  /* 54 */ 0x00000000, 0x00000000, 0x00000000, 0x00000000,
  /* 58 */ 0x00000000, 0x00000000, 0x00000000, 0x00000000,
  /* 5c */ 0x00000000, 0x00000000, 0x00000000, 0x00000000,
  /* 60 */ 0x00000000, 0x00000000, 0x00000000, 0x00000000,
  /* 64 */ 0x00000000, 0x00000000, 0x00000000, 0x00000000,
  /* 68 */ 0x00000000, 0x00000000, 0x00000000, 0x00000000,
  /* 6c */ 0x00000000, 0x00000000, 0x00000000, 0x00000000,
  /* 70 */ 0x00000000, 0x00000000, 0x00000000, 0x00000000,
  /* 74 */ 0x00000000, 0x00000000, 0x00000000, 0x00000000,
  /* 78 */ 0x00000000, 0x00000000, 0x00000000, 0x00000000,
  /* 7c */ 0x00000000, 0x00000000, 0x00000000, 0x00000000,

  /*** Single byte table, leaf: xx - offset 0x00080 ***/

  /* 80 */ 0x0000d090, 0x0000d091, 0x0000d092, 0x0000d093,
  /* 84 */ 0x0000d094, 0x0000d095, 0x0000d096, 0x0000d097,
  /* 88 */ 0x0000d098, 0x0000d099, 0x0000d09a, 0x0000d09b,
  /* 8c */ 0x0000d09c, 0x0000d09d, 0x0000d09e, 0x0000d09f,
  /* 90 */ 0x0000d0a0, 0x0000d0a1, 0x0000d0a2, 0x0000d0a3,
  /* 94 */ 0x0000d0a4, 0x0000d0a5, 0x0000d0a6, 0x0000d0a7,
  /* 98 */ 0x0000d0a8, 0x0000d0a9, 0x0000d0aa, 0x0000d0ab,
  /* 9c */ 0x0000d0ac, 0x0000d0ad, 0x0000d0ae, 0x0000d0af,
  /* a0 */ 0x0000d0b0, 0x0000d0b1, 0x0000d0b2, 0x0000d0b3,
  /* a4 */ 0x0000d0b4, 0x0000d0b5, 0x0000d0b6, 0x0000d0b7,
  /* a8 */ 0x0000d0b8, 0x0000d0b9, 0x0000d0ba, 0x0000d0bb,
  /* ac */ 0x0000d0bc, 0x0000d0bd, 0x0000d0be, 0x0000d0bf,
  /* b0 */ 0x00e29691, 0x00e29692, 0x00e29693, 0x00e29482,
  /* b4 */ 0x00e294a4, 0x00e295a1, 0x00e295a2, 0x00e29596,
  /* b8 */ 0x00e29595, 0x00e295a3, 0x00e29591, 0x00e29597,
  /* bc */ 0x00e2959d, 0x00e2959c, 0x00e2959b, 0x00e29490,
  /* c0 */ 0x00e29494, 0x00e294b4, 0x00e294ac, 0x00e2949c,
  /* c4 */ 0x00e29480, 0x00e294bc, 0x00e2959e, 0x00e2959f,
  /* c8 */ 0x00e2959a, 0x00e29594, 0x00e295a9, 0x00e295a6,
  /* cc */ 0x00e295a0, 0x00e29590, 0x00e295ac, 0x00e295a7,
  /* d0 */ 0x00e295a8, 0x00e295a4, 0x00e295a5, 0x00e29599,
  /* d4 */ 0x00e29598, 0x00e29592, 0x00e29593, 0x00e295ab,
  /* d8 */ 0x00e295aa, 0x00e29498, 0x00e2948c, 0x00e29688,
  /* dc */ 0x00e29684, 0x00e2968c, 0x00e29690, 0x00e29680,
  /* e0 */ 0x0000d180, 0x0000d181, 0x0000d182, 0x0000d183,
  /* e4 */ 0x0000d184, 0x0000d185, 0x0000d186, 0x0000d187,
  /* e8 */ 0x0000d188, 0x0000d189, 0x0000d18a, 0x0000d18b,
  /* ec */ 0x0000d18c, 0x0000d18d, 0x0000d18e, 0x0000d18f,
  /* f0 */ 0x0000d081, 0x0000d191, 0x0000d084, 0x0000d194,
  /* f4 */ 0x0000d087, 0x0000d197, 0x0000d08e, 0x0000d19e,
  /* f8 */ 0x0000c2b0, 0x00e28899, 0x0000c2b7, 0x00e2889a,
  /* fc */ 0x00e28496, 0x0000c2a4, 0x00e296a0, 0x0000c2a0
};
